...............................................
..*.....****..*.....*..****..*......**.........
..*.....*.....*.....*..*.....*.....*..*........
..*.....****...*...*...****..*.......*.........
..*.....*.......*.*....*.....*.....*..*........
..****..****.....*.....****..****...**.........
...............................................
...............................................
..........################.....................
...............................................
...#............................#..............
...#............................#..............
...#.........#.........#........#..............
...#............................#..............
...#............................#..............
...#.....#........#........#....#..............
...#............................#..............
...#............................#..............
...#.........#.........#........#..............
...#............................#..............
...#............................#..............
...#.....#........#........#....#..............
...#............................#..............
...#............................#..............
...............................................
..........################.....................
...............................................
...............................................
...............................................
...............................................