...............................................
..#####...###..........#######...#...#.........
..#..................................#.........
..#..................................#.........
..#..................................#.........
..#..................................#.........
...............................................
...............................................
...............................................
..#..................................#.........
..#..................................#.........
..#..................................#.........
..#..................................#.........
..#..................................#.........
..#..................................#.........
..#..................................#.........
..#..................................#.........
..#..................................#.........
.....................................#.........
..#..................................#.........
..######...#######...########...######.........
...............................................
...............................................
..*.....****..*.....*..****..*......**.........
..*.....*.....*.....*..*.....*.....*..*........
..*.....****...*...*...****..*.......*.........
..*.....*.......*.*....*.....*......*..........
..****..****.....*.....****..****..****........
...............................................
...............................................